R 500 600
NO textures/test4whitewall.xpm
SO textures/redbrick.xpm
EA textures/mossy.xpm
WE textures/greystone.xpm
CT textures/test2white.xpm
FT textures/test5sky.xpm
S textures/sprite7biggom.xpm

        1111111111111111111111111
        1000000000110000000000001
        1011000001110000222000001
        1001000000000000000000001
111111111011000001110000000000001
100000000011000001110111111111111
11110111111111011100000000001    
11110111111111011101010010001    
11000000110101011100000010201    
10002000000000001100000012221    
10000000000000001101010010221    
11000001110101011111011110N0111  
11110111 1110101 101111010001    
11111111 1111111 111111111111    
